_______________________________X
_______XXXXXXXXXXXXXX___________
_____XX_______________XX________
___XX__________________XXXXX____
___________________________XXX__
______________________________XX
__XX___________________________X
____XX__________________________
_____XX___________________XX___X
_____XXX_____________________XXX
_____XXXXX________________X____X
________XXXXXX____________X_____
__XX_____XXX____________________
_XXXX______XXX___________XXXXXXX
__XX_X_____XXXXXXXXXXXXXXXXX____
____XXXX________________________
____XXXX_______________________X
______________________________XX
